%%%%%%%%%%%%%%
%           G%
%G %    %%%%%%
%%%%         %
%G %      %%%%
%         %  %
%%%       %  %
%           P%
%%%%%%%%%%%%%%
% % % %%%%%%%%
%%%%%%%%%%%%%%
