%%%%%%%%%%%%%%
%           G%
%  %    %%%%%%
%%%%       ..%
%  %   .  %%%%
%         %..%
%%%       %  %
%..         P%
%%%%%%%%%%%%%%
% % % %%%%%%%%
%%%%%%%%%%%%%%
