%%%%%%%%%%%%%%
%           G%
%G %    %%%%%%
%%%%         %
%  %      %%%%
%      P  %  %
%%%       %  %
%            %
%%%%%%%%%%%%%%
% % % %%%%%%%%
%%%%%%%%%%%%%%
